00000000000000000000000000000000
00000000000000000000000000000000
00000000000000000000000000000000
66650000000000000000000000000000
00050000000000000000000000000000
00052000000000000000000000000000
00066666664000000000000000026666
00000000005200000000000006664000
00000000006666520000000024000000
00000000000000666666666664000000
00000000000000000000000000000000
00000000000000000000000000000000
00000000000000000000000000000000
00000000000000000000000000000000
00000000000000000000000000000000
00000000000000000000000000000000
00000000000000000000000000000000
00000000000000000000000000000000
*